%%%%%%%%%%%%%%%%%%
%o.o.o%o..o%o...o%
%%%.%%%.%%.G.%%%.%
%P%.% %.%%.%.%%%.%
% %.% %.%%.%.%%%.%
% %.% %.%%.%.%%%.%
% %.% %.%%.%.%%%G%
% %.% %.%%.%o...o%
% %.% %.%%.%.%%%%%
% %.% %.%%.%.%%%%%
% %.% %.%%.%.%%%%%
% %.% %.%%.%.%%%%%
% %.% %....%.%%%%%
% %.% %%  %% %%%%%
%            %%%%%
%%%%%%%%%%%%%%%%%%